252,128Te,76,52,6.94*10^31,"beta-,beta-",128
253,124Xe,70,54,5.68*10^29,gammagamma,124
254,78Kr,42,36,2.90*10^29,gammagamma,78
255,136Xe,82,54,7.5*10^28,"beta-,beta-",136
256,76Ge,44,32,5.642*10^28,"beta-,beta-",76
257,130Ba,74,56,3.79*10^28,gammagamma,130
258,130Te,78,52,2.496*10^28,"beta-,beta-",130
259,82Se,48,34,2.764*10^27,"beta-,beta-",82
260,48Ca,28,20,1.766*10^27,"beta-,beta-",48
261,116Cd,68,48,8.489*10^26,"beta-,beta-",116
262,209Bi,126,83,6.343*10^26,alpha,209
263,96Zr,56,40,7.384*10^26,"beta-,beta-",96
264,150Nd,90,60,2.935*10^26,"beta-,beta-",150
265,100Mo,58,42,2.231*10^26,"beta-,beta-",100
266,151Eu,88,63,1.458*10^26,alpha,151
267,180W,106,74,5.018*10^25,alpha,180
268,50V,27,23,8.552*10^24,beta+,50
269,174Hf,102,72,1.199*10^24,alpha,174
270,113Cd,65,48,2.537*10^23,beta-,113
271,148Sm,86,62,1.988*10^23,alpha,148
272,144Nd,84,60,7.227*10^22,alpha,144
273,186Os,110,76,6.312*10^22,alpha,186
274,115In,66,49,1.392*10^22,beta-,115
275,152Gd,88,64,3.408*10^21,alpha,152
276,184Os,108,76,3.53*10^20,alpha,184
277,190Pt,112,78,1.524*10^19,alpha,190
278,147Sm,85,62,3.364*10^18,alpha,147
279,138La,81,57,3.250*10^18,"beta+,beta-",138
280,87Rb,50,37,1.568*10^18,beta-,87
281,187Re,112,75,1.300*10^18,beta-,187
282,176Lu,105,71,1.187*10^18,beta-,176
283,232Th,142,90,4.434*10^17,"alpha,SF",232
284,238U,146,92,1.410*10^17,"alpha,SF,beta-,beta-",238
285,40K,21,19,3.938*10^16,"beta-,beta+",40
286,235U,143,92,2.222*10^16,"alpha,SF",235
287,146Sm,84,62,2.903*10^15,alpha,146
288,244Pu,150,94,2.566*10^15,"alpha,SF",244
289,92Nb,51,41,1.095*10^15,beta+,92
290,236U,144,92,7.391*10^14,"alpha,SF",236
291,205Pb,123,82,5.459*10^14,beta+,205
292,129I,76,53,5.093*10^14,beta-,129
293,247Cm,151,96,4.923*10^14,alpha,247
294,182Hf,110,72,2.809*10^14,beta-,182
295,107Pd,61,46,2.051*10^14,beta-,107
296,97Tc,54,43,1.329*10^14,beta+,97
297,98Tc,55,43,1.325*10^14,beta-,98
298,53Mn,28,25,1.180*10^14,beta+,53
299,60Fe,34,26,8.268*10^13,beta-,60
300,210mBi,127,83,9.594*10^13,alpha,210
301,237Np,144,93,6.766*10^13,"alpha,SF",237
302,150Gd,86,64,5.649*10^13,alpha,150
303,93Zr,53,40,4.828*10^13,beta-,93
304,154Dy,88,66,4.415*10^13,alpha,154
305,10Be,6,4,4.377*10^13,beta-,10
306,135Cs,80,55,4.194*10^13,beta-,135
307,26Al,13,13,2.263*10^13,beta+,26
308,242Pu,148,94,1.183*10^13,"alpha,SF",242
309,208Bi,125,83,1.161*10^13,beta+,208
310,248Cm,152,96,1.098*10^13,"alpha,SF",248
311,36Cl,19,17,9.499*10^12,"beta-,beta+",36
312,79Se,45,34,9.309*10^12,beta-,79
313,234U,142,92,7.747*10^12,"alpha,SF",234
314,126Sn,76,50,7.258*10^12,beta-,126
315,81Kr,45,36,7.227*10^12,beta+,81
316,99Tc,56,43,6.662*10^12,beta-,99
317,186mRe,111,75,6.312*10^12,IT,186
318,233U,141,92,5.024*10^12,"alpha,SF",233
319,236Np,143,93,4.860*10^12,"beta+,beta-,alpha",236
320,41Ca,21,20,3.219*10^12,beta+,41
321,59Ni,31,28,2.398*10^12,beta+,59
322,230Th,140,90,2.379*10^12,"alpha,SF",230
323,137La,80,57,1.893*10^12,beta+,137
324,202Pb,120,82,1.657*10^12,beta+,202
325,231Pa,140,91,1.034*10^12,"alpha,SF",231
326,239Pu,145,94,7.609*10^11,"alpha,SF",239
327,94Nb,53,41,6.406*10^11,beta-,94
328,250Cm,154,96,2.619*10^11,"SF,alpha,beta-",250
329,245Cm,149,96,2.60*10^11,"alpha,SF",245
330,243Am,148,95,2.326*10^11,"alpha,SF",243
331,229Th,139,90,2.316*10^11,alpha,229
332,240Pu,146,94,2.070*10^11,"alpha,SF",240
333,14C,8,6,1.799*10^11,beta-,14
334,93Mo,51,42,1.53*10^11,beta+,93
335,246Cm,150,96,1.502*10^11,"alpha,SF",246
336,163Ho,96,67,1.442*10^11,beta+,163
337,226Ra,138,88,5.049*10^10,alpha,226
338,247Bk,150,97,4.355*10^10,alpha,247
339,166mHo,99,67,3.787*10^10,beta-,166
340,251Cf,153,98,2.834*10^10,"alpha,SF",251
341,91Nb,50,41,2.146*10^10,beta+,91
342,194Hg,114,80,1.401*10^10,beta+,194
343,108mAg,61,47,1.382*10^10,"beta+,IT",108
344,241Am,146,95,1.364*10^10,"alpha,SF",241
345,249Cf,151,98,1.108*10^10,"alpha,SF",249
346,39Ar,21,18,8.489*10^9,beta-,39
347,192mIr,115,77,7.605*10^9,IT,192
348,158Tb,93,65,5.680*10^9,"beta+,beta-",158
349,242mAm,147,95,4.450*10^9,"IT,alpha,SF",242
350,32Si,18,14,4.166*10^9,beta-,32
351,209Po,125,84,3.913*10^9,"alpha,beta+",209
352,63Ni,35,28,3.159*10^9,beta-,63
353,151Sm,89,62,2.840*10^9,beta-,151
354,238Pu,144,94,2.768*10^9,"alpha,SF",238
355,148Gd,84,64,2.74*10^9,alpha,148
356,157Tb,92,65,2.241*10^9,beta+,157
357,232U,140,92,2.174*10^9,"alpha,SF",232
358,44Ti,22,22,1.893*10^9,beta+,44
359,193Pt,115,78,1.578*10^9,beta+,193
360,121mSn,71,50,1.385*10^9,"IT,beta-",121
361,150Eu,87,63,1.164*10^9,beta+,150
362,42Ar,24,18,1.038*10^9,beta-,42
363,207Bi,124,83,1.038*10^9,beta+,207
364,178m2Hf,106,72,9.776*10^8,IT,178
365,137Cs,82,55,9.477*10^8,beta-,137
366,243Cm,147,96,9.183*10^8,"alpha,beta+,SF",243
367,90Sr,52,38,9.120*10^8,beta-,90
368,210Pb,128,82,7.006*10^8,"beta-,alpha",210
369,227Ac,138,89,6.871*10^8,"beta-,alpha",227
370,244Cm,148,96,5.712*10^8,"alpha,SF",244
371,145Pm,84,61,5.586*10^8,"beta+,alpha",145
372,93mNb,52,41,5.084*10^8,IT,93
373,241Pu,147,94,4.510*10^8,"beta-,alpha,SF",241
374,113mCd,65,48,4.380*10^8,"beta-,IT",113
375,152Eu,89,63,4.262*10^8,"beta+,beta-",152
376,250Cf,152,98,4.128*10^8,"alpha,SF",250
377,3H,2,1,3.888*10^8,beta-,3
378,85Kr,49,36,3.384*10^8,beta-,85
379,133Ba,77,56,3.319*10^8,beta+,133
380,248Bk,151,97,2.84*10^8,alpha,248
381,154Eu,91,63,2.711*10^8,"beta-, beta+",154
382,194Os,118,76,1.893*10^8,beta-,194
383,228Ra,140,88,1.815*10^8,beta-,228
384,146Pm,85,61,1.745*10^8,"beta+, beta-",146
385,60Co,33,27,1.663*10^8,beta-,60
386,155Eu,92,63,1.500*10^8,beta-,155
387,204Tl,123,81,1.193*10^8,"beta-, beta+",204
388,174Lu,103,71,1.045*10^8,beta+,174
389,101Rh,56,45,1.041*10^8,beta+,101
390,102mRh,57,45,9.152*10^7,"beta+, IT",102
391,208Po,124,84,9.145*10^7,"alpha, beta+",208
392,236Pu,142,94,9.019*10^7,"alpha, SF",236
393,125Sb,74,51,8.705*10^7,beta-,125
394,55Fe,29,26,8.637*10^7,beta+,55
395,252Cf,154,98,8.347*10^7,"alpha, SF",252
396,147Pm,86,61,8.279*10^7,beta-,147
397,22Na,11,11,8.213*10^7,beta+,22
398,134Cs,79,55,6.517*10^7,"beta-, beta+",134
399,171Tm,102,69,6.059*10^7,beta-,171
400,228Th,138,90,6.033*10^7,alpha,228
401,172Hf,100,72,5.901*10^7,beta+,172
402,179Ta,106,73,5.743*10^7,beta+,179
403,173Lu,102,71,4.323*10^7,beta+,173
404,252Es,153,99,4.075*10^7,"alpha, beta+, beta-",252
405,109Cd,61,48,3.986*10^7,beta+,109
406,235Np,142,93,3.422*10^7,"beta+, alpha",235
407,106Ru,62,44,3.228*10^7,beta-,106
408,144Pm,83,61,3.136*10^7,beta+,144
409,145Sm,83,62,2.938*10^7,beta+,145
410,248Cf,150,98,2.881*10^7,"alpha, SF",248
411,249Bk,152,97,2.851*10^7,"beta-, alpha, SF",249
412,49V,26,23,2.843*10^7,beta+,49
413,54Mn,29,25,2.697*10^7,"beta+, beta-",54
414,119m1Sn,69,50,2.534*10^7,IT,119
415,144Ce,86,58,2.462*10^7,beta-,144
416,254Es,155,99,2.382*10^7,"alpha, beta-, SF, beta+",254
417,57Co,30,27,2.348*10^7,beta+,57
418,68Ge,36,32,2.341*10^7,beta+,68
419,143Pm,82,61,2.290*10^7,beta+,143
420,110mAg,63,47,2.158*10^7,"beta-, IT",110
421,65Zn,35,30,2.105*10^7,beta+,65
422,153Gd,89,64,2.077*10^7,beta+,153
423,102Rh,57,45,1.788*10^7,"beta+, beta-",102
424,195Au,116,79,1.608*10^7,beta+,195
425,194mIr,117,77,1.477*10^7,beta-,194
426,184mRe,109,75,1.460*10^7,"IT, beta+",184
427,242Cm,146,96,1.407*10^7,"alpha, SF",242
428,45Ca,25,20,1.405*10^7,beta-,45
429,177mLu,106,71,1.386*10^7,"beta-, IT",177
430,121mTe,69,52,1.331*10^7,"IT, beta+",121
431,159Dy,93,66,1.248*10^7,beta+,159
432,174m1Lu,103,71,1.227*10^7,"IT, EC",174
433,210Po,126,84,1.196*10^7,alpha,210
434,139Ce,81,58,1.189*10^7,beta+,139
435,123Sn,73,50,1.116*10^7,beta-,123
436,170Tm,101,69,1.111*10^7,"beta-, beta+",170
437,151Gd,87,64,1.071*10^7,"beta+, alpha",151
438,181W,107,74,1.047*10^7,beta+,181
439,75Se,41,34,1.035*10^7,beta+,75
440,123mTe,71,52,1.03*10^7,IT,123
441,113Sn,63,50,9.944*10^6,beta+,113
442,182Ta,109,73,9.887*10^6,beta-,182
443,127mTe,75,52,9.418*10^6,"IT, beta-",127
444,88Y,49,39,9.212*10^6,beta+,88
445,257Fm,157,100,8.683*10^6,"alpha, SF",257
446,185Os,109,76,8.087*10^6,beta+,185
447,168Tm,99,69,8.044*10^6,"beta+, beta-",168
448,149Eu,86,63,8.044*10^6,beta+,149
449,97mTc,54,43,7.862*10^6,"IT, EC",97
450,35S,19,16,7.561*10^6,beta-,35
451,83Rb,46,37,7.448*10^6,beta+,83
452,46Sc,25,21,7.239*10^6,beta-,46
453,88Zr,48,40,7.206*10^6,beta+,88
454,73As,40,33,6.938*10^6,beta+,73
455,56Co,29,27,6.673*10^6,beta+,56
456,185W,111,74,6.489*10^6,beta-,185
457,192Ir,115,77,6.379*10^6,"beta-, EC",192
458,160Tb,95,65,6.247*10^6,beta-,160
459,58Co,31,27,6.122*10^6,beta+,58
460,183Re,108,75,6.048*10^6,beta+,183
461,175Hf,103,72,6.048*10^6,beta+,175
462,188W,114,74,6.029*10^6,beta-,188
463,85Sr,47,38,5.602*10^6,beta+,85
464,95Zr,55,40,5.532*10^6,beta-,95
465,95mTc,52,43,5.270*10^6,"beta+, IT",95
466,91mNb,50,41,5.258*10^6,"IT, EC",91
467,254Cf,156,98,5.227*10^6,"SF, alpha",254
468,124Sb,73,51,5.194*10^6,beta-,124
469,125I,72,53,5.132*10^6,beta+,125
470,91Y,52,39,5.055*10^6,beta-,91
471,125mTe,73,52,4.959*10^6,IT,125
472,148Eu,85,63,4.709*10^6,"beta+, alpha",148
473,7Be,3,4,4.598*10^6,beta+,7
474,258Md,157,101,4.450*10^6,"alpha, SF",258
475,89Sr,51,38,4.369*10^6,beta-,89
476,114mIn,65,49,4.278*10^6,"IT, beta+",114
477,146Gd,82,64,4.171*10^6,beta+,146
478,203Hg,123,80,4.026*10^6,beta-,203
479,237Pu,143,94,3.905*10^6,"beta+, alpha",237
480,115mCd,67,48,3.850*10^6,beta-,115
481,59Fe,33,26,3.844*10^6,beta-,59
482,181Hf,109,72,3.662*10^6,beta-,181
483,148mPm,87,61,3.567*10^6,"beta-, IT",148
484,105Ag,58,47,3.567*10^6,beta+,105
485,255Es,156,99,3.439*10^6,"beta-, alpha, SF",255
486,103Ru,59,44,3.392*10^6,beta-,103
487,127Xe,73,54,3.145*10^6,beta+,127
488,184Re,109,75,3.059*10^6,beta+,184
489,95Nb,54,41,3.023*10^6,beta-,95
490,37Ar,19,18,3.020*10^6,beta+,37
491,129mTe,77,52,2.903*10^6,"IT, beta-",129
492,84Rb,47,37,2.860*10^6,"beta+, beta-",84
493,241Cm,145,96,2.834*10^6,"beta+, alpha",241
494,141Ce,83,58,2.809*10^6,beta-,141
495,169Yb,99,70,2.767*10^6,beta+,169
496,260Md,159,101,2.748*10^6,"SF, alpha, beta+, beta-",260
497,51Cr,27,24,2.393*10^6,beta+,51
498,240Cm,144,96,2.333*10^6,"alpha, beta+, SF",240
499,233Pa,142,91,2.331*10^6,beta-,233
500,82Sr,44,38,2.208*10^6,beta+,82
501,33P,18,15,2.189*10^6,beta-,33
502,179m2Hf,107,72,2.164*10^6,IT,179
503,234Th,144,90,2.082*10^6,beta-,234
504,147Eu,84,63,2.082*10^6,"beta+, alpha",147
505,178W,104,74,1.866*10^6,beta+,178
506,230U,138,92,1.797*10^6,"alpha, SF",230
507,253Es,154,99,1.769*10^6,"alpha, SF",253
508,121Te,69,52,1.656*10^6,ε,121
509,227Th,137,90,1.614*10^6,alpha,227
510,86Rb,49,37,1.611*10^6,"beta-, beta+",86
511,253Cf,155,98,1.539*10^6,"beta-, alpha",253
512,74As,41,33,1.535*10^6,"beta+, beta-",74
513,230Pa,139,91,1.503*10^6,"beta+, beta-, alpha",230
514,103Pd,57,46,1.468*10^6,beta+,103
515,99Rh,54,45,1.391*10^6,beta+,99
516,48V,25,23,1.380*10^6,beta+,48
517,191Os,115,76,1.331*10^6,beta-,191
518,205Bi,122,83,1.323*10^6,beta+,205
519,156Eu,93,63,1.312*10^6,beta-,156
520,225Ra,137,88,1.287*10^6,beta-,225
521,32P,17,15,1.232*10^6,beta-,32
522,117mSn,67,50,1.21*10^6,IT,117
523,143Pr,84,59,1.172*10^6,beta-,143
524,189Ir,112,77,1.140*10^6,beta+,189
525,136Cs,81,55,1.127*10^6,beta-,136
526,126I,73,53,1.117*10^6,"beta+, beta-",126
527,140Ba,84,56,1.102*10^6,beta-,140
528,126Sb,75,51,1.067*10^6,beta-,126
529,202Tl,121,81,1.057*10^6,beta+,202
530,131mXe,77,54,1.023*10^6,IT,131
531,190Ir,113,77,1.018*10^6,beta+,190
532,131Ba,75,56,9.936*10^5,beta+,131
533,223Ra,135,88,9.876*10^5,alpha,223
534,71Ge,39,32,9.876*10^5,beta+,71
535,147Nd,87,60,9.487*10^5,beta-,147
536,246Pu,152,94,9.366*10^5,beta-,246
537,193mIr,116,77,9.098*10^5,IT,193
538,188Pt,110,78,8.813*10^5,"beta+, alpha",188
539,92mNb,51,41,8.770*10^5,"beta+, alpha",92
540,225Ac,136,89,8.571*10^5,alpha,225
541,131Cs,76,55,8.371*10^5,beta+,131
542,125Sn,75,50,8.329*10^5,beta-,125
543,169Er,101,68,8.115*10^5,beta-,169
544,149Gd,85,64,8.018*10^5,"beta+, alpha",149
545,167Tm,98,69,7.992*10^5,beta+,167
546,129mXe,75,54,7.672*10^5,IT,129
547,206Po,122,84,7.603*10^5,"beta+, alpha",206
548,72Se,38,34,7.258*10^5,beta+,72
549,106mAg,59,47,7.154*10^5,beta+,106
550,171Lu,100,71,7.119*10^5,beta+,171
551,131I,78,53,6.930*10^5,beta-,131
552,257Es,158,99,6.653*10^5,"beta-, SF",257
553,111Ag,64,47,6.437*10^5,beta-,111
554,161Tb,96,65,5.967*10^5,beta-,161
555,237U,145,92,5.832*10^5,beta-,237
556,172Lu,101,71,5.789*10^5,beta+,172
557,177Lu,106,71,5.743*10^5,beta-,177
558,132Cs,77,55,5.599*10^5,"beta+, beta-",132
559,206Bi,123,83,5.394*10^5,beta+,206
560,196Au,117,79,5.328*10^5,"beta+, beta-",196
561,56Ni,28,28,5.249*10^5,beta+,56
562,118Te,66,52,5.184*10^5,beta+,118
563,145Eu,82,63,5.124*10^5,beta+,145
564,120mSb,69,51,4.977*10^5,beta+,120
565,52Mn,27,25,4.831*10^5,beta+,52
566,148Pm,87,61,4.638*10^5,beta-,148
567,156Tb,91,65,4.622*10^5,beta+,156
568,155Tb,90,65,4.596*10^5,beta+,155
569,133Xe,79,54,4.530*10^5,beta-,133
570,183Ta,110,73,4.406*10^5,beta-,183
571,210Bi,127,83,4.330*10^5,"beta-, alpha",210
572,245Bk,148,97,4.268*10^5,"beta+, alpha",245
573,119mTe,67,52,4.061*10^5,"beta+, IT",119
574,146Eu,83,63,3.983*10^5,beta+,146
575,47Ca,27,20,3.919*10^5,beta-,47
576,234Np,141,93,3.802*10^5,beta+,234
577,101mRh,56,45,3.74*10^5,"ε, IT",101
578,193mPt,115,78,3.74*10^5,IT,193
579,96Tc,53,43,3.698*10^5,beta+,96
580,231U,139,92,3.629*10^5,"beta+, alpha",231
581,175Yb,105,70,3.616*10^5,beta-,175
582,124I,71,53,3.608*10^5,beta+,124
583,195mPt,117,78,3.46*10^5,IT,195
584,127Sb,76,51,3.326*10^5,beta-,127
585,222Rn,136,86,3.304*10^5,alpha,222
586,186Re,111,75,3.21*10^5,"beta-,e",186
587,224Ra,136,88,3.138*10^5,alpha,224
588,100Pd,54,46,3.136*10^5,beta+,100
589,95mNb,54,41,3.11*10^5,"IT, beta-",95
590,166Dy,100,66,2.938*10^5,beta-,166
591,140Nd,80,60,2.912*10^5,beta+,140
592,47Sc,26,21,2.894*10^5,beta-,47
593,87Y,48,39,2.873*10^5,beta+,87
594,89Zr,49,40,2.823*10^5,beta+,89
595,67Ga,36,31,2.819*10^5,beta+,67
596,132Te,80,52,2.768*10^5,beta-,132
597,134Ce,76,58,2.730*10^5,beta+,134
598,199Au,120,79,2.712*10^5,beta-,199
599,201Tl,120,81,2.625*10^5,beta+,201
600,253Fm,153,100,2.592*10^5,"beta+, alpha",253
601,191Pt,113,78,2.473*10^5,beta+,191
602,111In,62,49,2.423*10^5,beta+,111
603,97Ru,53,44,2.411*10^5,beta+,97
604,99Mo,57,42,2.375*10^5,beta-,99
605,122Sb,71,51,2.353*10^5,"beta-, beta+",122
606,71As,38,33,2.350*10^5,beta+,71
607,198Au,119,79,2.329*10^5,beta-,198
608,197Hg,117,80,2.309*10^5,beta+,197
609,90Y,51,39,2.306*10^5,beta-,90
610,182Re,107,75,2.304*10^5,beta+,182
611,172Tm,103,69,2.290*10^5,beta-,172
612,67Cu,38,29,2.226*10^5,beta-,67
613,44mSc,23,21,2.110*10^5,"IT, beta+",44
614,128Ba,72,56,2.100*10^5,beta+,128
615,77Br,42,35,2.053*10^5,beta+,77
616,166Yb,96,70,2.041*10^5,beta+,166
617,177Ta,104,73,2.036*10^5,beta+,177
618,239Np,146,93,2.036*10^5,beta-,239
619,153Tb,88,65,2.022*10^5,beta+,153
620,66Ni,38,28,1.966*10^5,beta-,66
621,247Pu,153,94,1.961*10^5,beta-,247
622,198m2Au,119,79,1.96*10^5,IT,198
623,115Cd,67,48,1.92*10^5,beta-,115
624,149Pm,88,61,1.911*10^5,beta-,149
625,133mXe,79,54,1.89*10^5,IT,133
626,203Pb,121,82,1.869*10^5,beta+,203
627,238Np,145,93,1.829*10^5,beta-,238
628,240Am,145,95,1.829*10^5,"beta+, alpha",240
629,172Er,104,68,1.775*10^5,beta-,172
630,170Lu,99,71,1.738*10^5,beta+,170
631,72Zn,42,30,1.674*10^5,beta-,72
632,153Sm,91,62,1.666*10^5,beta-,153
633,202Pt,124,78,1.584*10^5,beta-,202
634,48Sc,27,21,1.572*10^5,beta-,48
635,246Bk,149,97,1.555*10^5,"beta+, alpha",246
636,195mHg,115,80,1.498*10^5,"IT, beta+",195
637,188Ir,111,77,1.494*10^5,beta+,188
638,140La,83,57,1.450*10^5,beta-,140
639,254mEs,155,99,1.41*10^5,"beta-, IT, alpha, EC, SF",254
640,69Ge,37,32,1.406*10^5,beta+,69
641,133mBa,77,56,1.4*10^5,"IT,e",133
642,77As,44,33,1.398*10^5,beta-,77
643,119Sb,68,51,1.375*10^5,beta+,119
644,147Gd,83,64,1.370*10^5,beta+,147
645,194Au,115,79,1.369*10^5,beta+,194
646,229Pa,138,91,1.296*10^5,"beta+, alpha",229
647,246Cf,148,98,1.285*10^5,"alpha, beta+, SF",246
648,57Ni,29,28,1.282*10^5,beta+,57
649,105Rh,60,45,1.273*10^5,beta-,105
650,82Br,47,35,1.270*10^5,beta-,82
651,79Kr,43,36,1.261*10^5,beta+,79
652,137mCe,79,58,1.238*10^5,"IT, beta+",137
653,169Lu,98,71,1.226*10^5,beta+,169
654,143Ce,85,58,1.189*10^5,beta-,143
655,251Es,152,99,1.188*10^5,"beta+, alpha",251
656,83Sr,45,38,1.167*10^5,beta+,83
657,129Cs,74,55,1.154*10^5,beta+,129
658,268Db,163,105,1.152*10^5,"SF, EC, alpha[33]",268
659,232Pa,141,91,1.132*10^5,"beta-, beta+",232
660,193Os,117,76,1.084*10^5,beta-,193
661,165Tm,96,69,1.082*10^5,beta+,165
662,131mTe,79,52,1.080*10^5,"beta-, IT",131
663,226Ac,137,89,1.057*10^5,"beta-, beta+, alpha",226
664,160Er,92,68,1.029*10^5,beta+,160
665,151Pm,90,61,1.022*10^5,beta-,151
666,135mBa,79,56,1.01*10^5,IT,135
667,121Sn,71,50,9.73*10^4,beta-,121
668,166Ho,99,67,9.65*10^4,beta-,166
669,76As,43,33,9.454*10^4,beta-,76
670,200Tl,119,81,9.396*10^4,beta+,200
671,72As,39,33,9.360*10^4,beta+,72
672,231Th,141,90,9.187*10^4,"beta-, alpha",231
673,252Fm,152,100,9.140*10^4,"alpha, SF",252
674,156mTb,91,65,8.78*10^4,IT,156
675,189Re,114,75,8.748*10^4,beta-,189
676,197mHg,117,80,8.568*10^4,IT,197
677,187W,113,74,8.539*10^4,beta-,187
678,248mBk,151,97,8.532*10^4,"beta-,EC ",248
679,173Hf,101,72,8.496*10^4,beta+,173
680,96Nb,55,41,8.406*10^4,beta-,96
681,154m2Tb,89,65,8.172*10^4,"beta+,IT ",154
682,236mNp,143,93,8.1*10^4,"EC,beta- ",236
683,43K,24,19,8.028*10^4,beta-,43
684,182Os,106,76,7.956*10^4,beta+,182
685,228Pa,137,91,7.920*10^4,"beta+,alpha ",228
686,48Cr,24,24,7.762*10^4,beta+,48
687,154Tb,89,65,7.74*10^4,"beta+,beta- ",154
688,200Pb,118,82,7.740*10^4,beta+,200
689,112Pd,66,46,7.571*10^4,beta-,112
690,28Mg,16,12,7.529*10^4,beta-,28
691,100Rh,55,45,7.488*10^4,beta+,100
692,133I,80,53,7.488*10^4,beta-,133
693,122Xe,68,54,7.236*10^4,beta+,122
694,255Fm,155,100,7.225*10^4,"alpha,SF ",255
695,95Tc,52,43,7.2*10^4,beta+,95
696,181Re,106,75,7.164*10^4,beta+,181
697,197Pt,119,78,7.161*10^4,beta-,197
698,135La,78,57,7.020*10^4,beta+,135
699,194Ir,117,77,6.941*10^4,beta-,194
700,142Pr,83,59,6.883*10^4,"beta-,EC ",142
701,200mAu,121,79,6.732*10^4,"beta-,IT ",200
702,159Gd,95,64,6.652*10^4,beta-,159
703,135Ce,77,58,6.372*10^4,beta+,135
704,193Au,114,79,6.354*10^4,beta+,193
705,151Tb,86,65,6.339*10^4,"beta+,alpha ",151
706,55Co,28,27,6.311*10^4,beta+,55
707,152Tb,87,65,6.300*10^4,"beta+,alpha ",152
708,188Re,113,75,6.121*10^4,beta-,188
709,125Xe,71,54,6.084*10^4,beta+,125
710,97Zr,57,40,6.028*10^4,beta-,97
711,186Ir,109,77,5.990*10^4,beta+,186
712,86Zr,46,40,5.940*10^4,beta+,86
713,76Br,41,35,5.832*10^4,beta+,76
714,119Te,67,52,5.778*10^4,"EC,e+ ",119
715,242Am,147,95,5.767*10^4,"beta-,EC ",242
716,170Hf,98,72,5.764*10^4,beta+,170
717,157Eu,94,63,5.465*10^4,beta-,157
718,24Na,13,11,5.382*10^4,beta-,24
719,76Kr,40,36,5.328*10^4,beta+,76
720,86Y,47,39,5.306*10^4,beta+,86
721,211Rn,125,86,5.256*10^4,"beta+,alpha ",211
722,90Nb,49,41,5.256*10^4,beta+,90
723,185Ir,108,77,5.184*10^4,beta+,185
724,240U,148,92,5.076*10^4,beta-,240
725,72Ga,41,31,5.074*10^4,beta-,72
726,69mZn,39,30,4.954*10^4,"IT,beta- ",69
727,109Pd,63,46,4.932*10^4,beta-,109
728,87mY,48,39,4.813*10^4,"IT,beta+ ",87
729,123I,70,53,4.760*10^4,beta+,123
730,191mOs,115,76,4.716*10^4,IT,191
731,183Os,107,76,4.680*10^4,beta+,183
732,150mEu,87,63,4.608*10^4,"beta-,beta+",150
733,64Cu,35,29,4.572*10^4,"beta+,beta- ",64
734,182mRe,107,75,4.572*10^4,beta+,182
735,200Pt,122,78,4.500*10^4,beta-,200
736,130I,77,53,4.450*10^4,beta-,130
737,42K,23,19,4.436*10^4,beta-,42
738,171Hf,99,72,4.356*10^4,beta+,171
739,239Am,144,95,4.284*10^4,"beta+,alpha ",239
740,193mHg,113,80,4.248*10^4,"beta+,IT ",193
741,203Bi,120,83,4.234*10^4,beta+,203
742,77Ge,45,32,4.068*10^4,beta-,77
743,204Bi,121,83,4.039*10^4,beta+,204
744,189Pt,111,78,3.913*10^4,beta+,189
745,212Pb,130,82,3.830*10^4,beta-,212
746,195Hg,115,80,3.791*10^4,beta+,195
747,175Ta,102,73,3.780*10^4,beta+,175
748,245Pu,151,94,3.780*10^4,beta-,245
749,187Ir,110,77,3.780*10^4,beta+,187
750,165Er,97,68,3.730*10^4,beta+,165
751,93Y,54,39,3.665*10^4,beta-,93
752,244Am,149,95,3.636*10^4,beta-,244
753,266Lr,163,103,3.600*10^4,SF,266
754,154m1Tb,89,65,3.598*10^4,"beta+,IT",154
755,183mOs,107,76,3.564*10^4,"beta+,IT",183
756,155Dy,89,66,3.564*10^4,beta+,155
757,91Sr,53,38,3.467*10^4,beta-,91
758,196m2Au,117,79,3.456*10^4,IT,196
759,66Ga,35,31,3.416*10^4,beta+,66
760,156Sm,94,62,3.384*10^4,beta-,156
761,127Te,75,52,3.366*10^4,beta-,127
762,201Pb,119,82,3.359*10^4,beta+,201
763,152mEu,89,63,3.352*10^4,"beta-,beta+",152
764,62Zn,32,30,3.307*10^4,beta+,62
765,135Xe,81,54,3.290*10^4,beta-,135
766,58mCo,31,27,3.276*10^4,IT,58
767,128Sb,77,51,3.244*10^4,beta-,128
768,137Ce,79,58,3.24*10^4,beta+,137
769,234Pu,140,94,3.168*10^4,"beta+,alpha ",234
770,184Ta,111,73,3.132*10^4,beta-,184
771,250Es,151,99,3.096*10^4,"beta+,alpha ",250
772,101Pd,55,46,3.049*10^4,beta+,101
773,52Fe,26,26,2.979*10^4,beta+,52
774,173Tm,104,69,2.966*10^4,beta-,173
775,180Ta,107,73,2.935*10^4,"EC,beta- ",180
776,157Dy,91,66,2.930*10^4,beta+,157
777,210At,125,85,2.916*10^4,"beta+,alpha ",210
778,176Ta,103,73,2.912*10^4,beta+,176
779,166Tm,97,69,2.772*10^4,beta+,166
780,256mEs,157,99,2.736*10^4,beta-,256
781,171Er,103,68,2.706*10^4,beta-,171
782,199Tl,118,81,2.671*10^4,beta+,199
783,211At,126,85,2.597*10^4,"beta+,alpha ",211
784,73Se,39,34,2.574*10^4,beta+,73
785,93mMo,51,42,2.466*10^4,"IT,beta+ ",93
786,234Pa,143,91,2.412*10^4,beta-,234
787,135I,82,53,2.365*10^4,beta-,135
788,107Cd,59,48,2.340*10^4,beta+,107
789,82mRb,45,37,2.330*10^4,"beta+,IT ",82
790,153Dy,87,66,2.304*10^4,"beta+,alpha ",153
791,127Cs,72,55,2.250*10^4,beta+,127
792,228Ac,139,89,2.214*10^4,beta-,228
793,99mTc,56,43,2.162*10^4,"IT,beta- ",99
794,145Pr,86,59,2.154*10^4,beta-,145
795,189mOs,113,76,2.092*10^4,IT,189
796,207Po,123,84,2.088*10^4,"beta+,alpha ",207
797,90Mo,48,42,2.002*10^4,beta+,90
798,257Md,156,101,1.987*10^4,"EC,alpha ",257
799,111mPd,65,46,1.980*10^4,"IT,beta- ",111
800,139mNd,79,60,1.980*10^4,"beta+,IT ",139
801,180mHf,108,72,1.969*10^4,"IT,beta- ",180
802,209At,124,85,1.948*10^4,"beta+,alpha ",209
803,113Ag,66,47,1.933*10^4,beta-,113
804,156m2Tb,91,65,1.908*10^4,IT ,156
805,198Tl,117,81,1.908*10^4,beta+,198
806,251Fm,151,100,1.908*10^4,"beta+,alpha ",251
807,138Nd,78,60,1.814*10^4,beta+,138
808,160mHo,93,67,1.807*10^4,"IT,beta+ ",160
809,118mSb,67,51,1.800*10^4,beta+,118
810,243Pu,149,94,1.784*10^4,beta-,243
811,192Au,113,79,1.778*10^4,beta+,192
812,110In,61,49,1.764*10^4,beta+,110
813,133mCe,75,58,1.764*10^4,beta+,133
814,94Tc,51,43,1.758*10^4,beta+,94
815,85mY,46,39,1.750*10^4,"beta+,IT ",85
816,73Ga,42,31,1.750*10^4,beta-,73
817,192Hg,112,80,1.746*10^4,beta+,192
818,132La,75,57,1.728*10^4,beta+,132
819,99mRh,54,45,1.692*10^4,"beta+,IT ",99
820,267Db,162,105,1.656*10^4,SF,267
821,179Lu,108,71,1.652*10^4,beta-,179
822,81Rb,44,37,1.645*10^4,beta+,81
823,243Bk,146,97,1.620*10^4,"beta+,alpha ",243
824,115mIn,66,49,1.615*10^4,"IT,beta- ",115
825,85mKr,49,36,1.613*10^4,"beta-,IT ",85
826,105Ru,61,44,1.598*10^4,beta-,105
827,80mBr,45,35,1.591*10^4,IT,80
828,139Pr,80,59,1.588*10^4,beta+,139
829,129Sb,78,51,1.584*10^4,beta-,129
830,244Bk,147,97,1.566*10^4,"beta+,alpha ",244
831,109In,60,49,1.512*10^4,beta+,109
832,184Hf,112,72,1.483*10^4,beta-,184
833,149Tb,84,65,1.482*10^4,"beta+,alpha ",149
834,110Sn,60,50,1.480*10^4,beta+,110
835,44Sc,23,21,1.429*10^4,beta+,44
836,71mZn,41,30,1.426*10^4,"beta-,IT ",71
837,141La,84,57,1.411*10^4,beta-,141
838,133La,76,57,1.408*10^4,beta+,133
839,43Sc,22,21,1.401*10^4,beta+,43
840,195mIr,118,77,1.368*10^4,"beta-,IT ",195
841,193Hg,113,80,1.368*10^4,beta+,193
842,176mLu,105,71,1.319*10^4,"beta-,EC ",176
843,262Lr,159,103,1.296*10^4,"SF,beta+,alpha",262
844,202mPb,120,82,1.274*10^4,"IT,beta+ ",202
845,92Y,53,39,1.274*10^4,beta-,92
846,204Po,120,84,1.271*10^4,"beta+,alpha ",204
847,132Ce,74,58,1.264*10^4,beta+,132
848,150Tb,85,65,1.253*10^4,"beta+,alpha ",150
849,117mCd,69,48,1.210*10^4,beta-,117
850,61Cu,32,29,1.200*10^4,beta+,61
851,209Pb,127,82,1.171*10^4,beta-,209
852,254Fm,154,100,1.166*10^4,"alpha,SF ",254
853,250Bk,153,97,1.156*10^4,beta-,250
854,161Er,93,68,1.156*10^4,beta+,161
855,190mRe,115,75,1.152*10^4,"beta- ,IT",190
856,90mY,51,39,1.148*10^4,"IT,beta- ",90
857,191Au,112,79,1.145*10^4,beta+,191
858,173Ta,100,73,1.130*10^4,beta+,173
859,112Ag,65,47,1.127*10^4,beta-,112
860,247Cf,149,98,1.120*10^4,"beta+,alpha ",247
861,184Ir,107,77,1.112*10^4,beta+,184
862,190m3Ir,113,77,1.111*10^4,"beta+,IT ",190
863,45Ti,23,22,1.109*10^4,beta+,45
864,167Ho,100,67,1.081*10^4,beta-,167
865,264Lr,161,103,1.081*10^4,SF,264
866,134Sm,72,62,1.048*10^4,IT,134
867,239Cm,143,96,1.044*10^4,"beta+,alpha ",239
868,197Tl,116,81,1.022*10^4,beta+,197
869,88Kr,52,36,1.022*10^4,beta-,88
870,38S,22,16,1.022*10^4,beta-,38
871,87mSr,49,38,1.013*10^4,"IT,EC ",87
872,117Sb,66,51,1.008*10^4,beta+,117
873,224Ac,135,89,1.001*10^4,"beta+,alpha ",224
874,93Tc,50,43,9.900*10^3,beta+,93
875,85Y,46,39,9.648*10^3,beta+,85
876,150Pm,89,61,9.648*10^3,beta-,150
877,92Sr,54,38,9.576*10^3,beta-,92
878,256Fm,156,100,9.456*10^3,"SF,alpha ",256
879,31Si,17,14,9.438*10^3,beta-,31
880,56Mn,31,25,9.284*10^3,beta-,56
881,65Ni,37,28,9.062*10^3,beta-,65
882,195Ir,118,77,9*10^3,beta-,195
883,176W,102,74,9.000*10^3,beta+,176
884,117Cd,69,48,8.964*10^3,beta-,117
885,116Te,64,52,8.964*10^3,beta+,116
886,141Nd,81,60,8.964*10^3,beta+,141
887,161Ho,94,67,8.928*10^3,beta+,161
888,210Rn,124,86,8.640*10^3,"alpha ,beta+",210
889,198Pb,116,82,8.640*10^3,beta+,198
890,238Cm,142,96,8.640*10^3,"beta+,alpha",238
891,83Br,48,35,8.640*10^3,beta-,83
892,152Dy,86,66,8.568*10^3,"beta+,alpha ",152
893,178mTa,105,73,8.496*10^3,beta+,178
894,187Pt,109,78,8.460*10^3,beta+,187
895,165Dy,99,66,8.402*10^3,beta-,165
896,132I,79,53,8.262*10^3,beta-,132
897,158Er,90,68,8.244*10^3,beta+,158
898,66Ge,34,32,8.136*10^3,beta+,66
899,129Ba,73,56,8.028*10^3,beta+,129
900,150Sm,88,62,7.992*10^3,"beta+,alpha ",150
901,177W,103,74,7.920*10^3,beta+,177
902,106mRh,61,45,7.860*10^3,beta-,106
903,129mBa,73,56,7.776*10^3,"beta+,IT ",129
904,138mPr,79,59,7.632*10^3,beta+,138
905,121I,68,53,7.632*10^3,beta+,121
906,127Sn,77,50,7.560*10^3,beta-,127
907,123Xe,69,54,7.488*10^3,beta+,123
908,186Pt,108,78,7.488*10^3,"beta+,alpha ",186
909,245Am,150,95,7.380*10^3,beta-,245
910,89Nb,48,41,7.308*10^3,beta+,89
911,195mOs,119,76,7.2*10^3,"beta-,IT ",195
912,117mIn,68,49,6.972*10^3,"beta-,IT ",117
913,186mIr,109,77,6.912*10^3,"beta+,IT ",186
914,177Yb,107,70,6.880*10^3,beta-,177
915,198mTl,117,81,6.732*10^3,"beta+,IT ",198
916,196Tl,115,81,6.624*10^3,beta+,196
917,83m2Kr,47,36,6.588*10^3,IT,83
918,18F,9,9,6.585*10^3,beta+,18
919,41Ar,23,18,6.577*10^3,beta-,41
920,163Tm,94,69,6.516*10^3,beta+,163
921,239Pa,148,91,6.480*10^3,beta-,239
922,201Bi,118,83,6.480*10^3,"beta+,alpha",201
923,207At,122,85,6.480*10^3,"beta+,alpha ",207
924,224Rn,138,86,6.420*10^3,beta-,224
925,80Sr,42,38,6.378*10^3,beta+,80
926,181Os,105,76,6.300*10^3,beta+,181
927,205Po,121,84,6.264*10^3,"beta+,alpha ",205
928,149Nd,89,60,6.221*10^3,beta-,149
929,202Bi,119,83,6.192*10^3,"beta+,alpha ",202
930,249Es,150,99,6.132*10^3,"beta+~,alpha ",249
931,147Tb,82,65,6.120*10^3,beta+,147
932,87Zr,47,40,6.048*10^3,beta+,87
933,126Ba,70,56,6.000*10^3,beta+,126
934,113mIn,64,49,5.968*10^3,IT,113
935,61Co,34,27,5.940*10^3,beta-,61
936,95Ru,51,44,5.915*10^3,beta+,95
937,238Am,143,95,5.880*10^3,"beta+,alpha ",238
938,208At,123,85,5.868*10^3,"beta+,alpha ",208
939,133Ce,75,58,5.82*10^3,beta+,133
940,75Br,40,35,5.802*10^3,beta+,75
941,152m5Eu,89,63,5.76*10^3,IT,152
942,259Md,158,101,5.760*10^3,"SF,alpha ",259
943,197mPt,119,78,5.725*10^3,"IT,beta- ",197
944,230Ra,142,88,5.580*10^3,beta-,230
945,142La,85,57,5.466*10^3,beta-,142
946,78As,45,33,5.442*10^3,beta-,78
947,199Pb,117,82,5.400*10^3,beta+,199
948,78Ge,46,32,5.280*10^3,beta-,78
949,255Cf,157,98,5.100*10^3,beta-,255
950,196mTl,115,81,5.076*10^3,"beta+,IT ",196
951,196mIr,119,77,5.040*10^3,"beta-,IT ",196
952,132mI,79,53,4.993*10^3,"IT,beta- ",132
953,139Ba,83,56,4.984*10^3,beta-,139
954,75Ge,43,32,4.967*10^3,beta-,75
955,120I,67,53,4.896*10^3,beta+,120
956,266Db,161,105,4.8*10^3,"alpha ?,SF ?,beta+ ?",266
957,256Md,155,101,4.620*10^3,"beta+,alpha ",256
958,137Pr,78,59,4.608*10^3,beta+,137
959,87Kr,51,36,4.578*10^3,beta-,87
960,164Yb,94,70,4.548*10^3,beta+,164
961,163Er,95,68,4.500*10^3,beta+,163
962,77Kr,41,36,4.464*10^3,beta+,77
963,178Yb,108,70,4.440*10^3,beta-,178
964,237Am,142,95,4.380*10^3,"beta+,alpha ",237
965,142Sm,80,62,4.349*10^3,beta+,142
966,97Nb,56,41,4.326*10^3,beta-,97
967,185Pt,107,78,4.254*10^3,beta+,185
968,195Tl,114,81,4.176*10^3,beta+,195
969,129Te,77,52,4.176*10^3,beta-,129
970,104Ag,57,47,4.152*10^3,beta+,104
971,110mIn,61,49,4.146*10^3,beta+,110
972,174Ta,101,73,4.104*10^3,beta+,174
973,68Ga,37,31,4.063*10^3,beta+,68
974,85mSr,47,38,4.058*10^3,"IT,beta+ ",85
975,190mIr,113,77,4.032*10^3,IT,190
976,162mHo,95,67,4.020*10^3,"IT,beta+ ",162
977,204m2Pb,122,82,4.016*10^3,IT,204
978,89mNb,48,41,3.96*10^3,beta+,89
979,103Ag,56,47,3.942*10^3,beta+,103
980,249Cm,153,96,3.849*10^3,beta-,249
981,183Hf,111,72,3.841*10^3,beta-,183
982,229Ac,140,89,3.762*10^3,beta-,229
983,117Te,65,52,3.720*10^3,beta+,117
984,240Np,147,93,3.714*10^3,beta-,240
985,182mHf,110,72,3.69*10^3,"beta-,IT ",182
986,212Bi,129,83,3.633*10^3,"beta-,alpha ",212
987,116mSb,65,51,3.618*10^3,beta+,116
988,148Tb,83,65,3.600*10^3,beta+,148
989,270Db,165,105,3.600*10^3,"alpha,SF,gamma?",270
1000,211Po,127,84,0.515*10^0,alpha,211
1001,204At,119,85,5.502*10^2,beta+,204
1002,206At,121,85,1.8403*10^3,beta+,206
1003,220At,135,85,2.232*10^2,beta-,220
1004,80Br,45,35,1.0608*10^3,beta-,80
1005,219Rn,133,86,3.93*10^0,alpha,219
1006,215Po,131,84,0.1781*10^-1,"alpha,beta-",215
1007,211Pb,129,82,2.167*10^3,beta-,211
1008,211Bi,128,83,1.284*10^2,"alpha,beta-",211
1009,207Tl,126,81,2.862*10^2,beta-,207
1010,215At,130,85,1.022*10^-3,alpha,215
1011,223Fr,136,87,1.320*10^3,"beta-,alpha",223
1012,218Po,134,84,1.858*10^2,alpha,218
1013,214Po,130,84,1.64*10^-4,alpha,214
1014,214Pb,132,82,1.609*10^3,beta-,214
1015,214Bi,131,83,1.188*10^3,beta-,214
1016,206Tl,125,81,2.521*10^2,beta-,206
1017,206Hg,126,80,4.992*10^2,beta-,206
